question	answer	note	category
空港でチェックインする際の表現は？	I'd like to check in for my flight to Tokyo. Here's my passport and booking reference.	check in（チェックイン）, booking reference（予約番号）	travel
ホテルで部屋を予約する表現は？	I have a reservation under the name Smith for a double room for three nights.	reservation（予約）, double room（ダブルルーム）	travel
レストランで予約をする表現は？	I'd like to make a reservation for two people at 7 PM tomorrow evening.	make a reservation（予約する）, tomorrow evening（明日の夕方）	travel
タクシーの行き先を伝える表現は？	Could you take me to the central station, please? How much will it cost approximately?	take me to（～に連れて行く）, approximately（おおよそ）	travel
道に迷ったときに道を尋ねる表現は？	Excuse me, could you tell me how to get to the museum from here? Is it within walking distance?	how to get to（～への行き方）, within walking distance（徒歩圏内）	travel
お店で買い物をする際の表現は？	I'm just browsing for now. Do you have this in a different size/color?	browsing（見ているだけ）, different size/color（別のサイズ・色）	travel
レストランで注文する表現は？	I'd like to order the chef's special, please. Does it contain any nuts? I have an allergy.	chef's special（シェフのおすすめ）, allergy（アレルギー）	travel
トラブル時に助けを求める表現は？	Excuse me, I need some help. I've lost my wallet/passport. Who should I contact?	lost my wallet/passport（財布・パスポートをなくした）, contact（連絡する）	travel
公共交通機関の利用方法を尋ねる表現は？	Could you tell me which bus goes to the city center? How often does it run?	which bus（どのバス）, how often（どのくらいの頻度で）	travel
観光スポットについて質問する表現は？	What time does the museum open? Is there an entrance fee? Are guided tours available?	entrance fee（入場料）, guided tours（ガイド付きツアー）	travel
会議で意見を述べる際の効果的な表現は？	I'd like to share my perspective on this matter. In my opinion, we should consider three key factors before making a decision.	share my perspective（私の視点を共有する）, key factors（重要な要素）	business
プロジェクトの進捗状況を報告するには？	Currently, we're on track with the project timeline. We've completed the initial phase and are now moving into development.	on track（予定通り）, initial phase（初期段階）	business
同僚に協力を依頼する丁寧な表現は？	I was wondering if you might be able to help me with this report? Your expertise would be invaluable.	wondering if（～できるかと思いまして）, invaluable（非常に価値のある）	business
顧客からのクレームに対応する際の適切な表現は？	I sincerely apologize for the inconvenience this has caused. Let me assure you that we'll resolve this issue promptly.	sincerely apologize（心からお詫びする）, resolve this issue（この問題を解決する）	business
プレゼンテーションを始める際の効果的な導入は？	Today, I'll be discussing our new marketing strategy. By the end of this presentation, you'll understand how it addresses our current challenges.	discussing（説明する）, addresses our challenges（課題に対処する）	business
会議の議題を提案するには？	I suggest we add the budget review to our agenda, as it's critical for our quarterly planning.	suggest（提案する）, critical for（～に不可欠な）	business
締め切りの延長を依頼する丁寧な表現は？	Due to unforeseen circumstances, I'm requesting an extension on the deadline. Would it be possible to submit the report by next Friday?	unforeseen circumstances（予期せぬ状況）, requesting an extension（延長を要請する）	business
同僚の仕事を褒める表現は？	Your attention to detail on this project was impressive. It really contributed to our successful outcome.	attention to detail（細部への注意）, contributed to（～に貢献した）	business
ビジネスメールの締めくくりに適した表現は？	I look forward to your response and am available to discuss this further at your convenience.	look forward to（楽しみにしている）, at your convenience（ご都合の良いときに）	business
会議で意見の相違がある場合の対応は？	I understand your perspective, but I'd like to suggest an alternative approach that might address both our concerns.	perspective（視点）, alternative approach（代替案）	business